#this is a testing map
width: 30
height: 30
#start position in format x y
start: 10 10

0 1 2 2 1 0 1 2 2 2 0 1 2 0 1 2 1 0 1 0 1 2 1 0 1 2 1 0 1 2
1 2 0 2 1 2 0 1 2 1 2 2 1 1 0 2 1 2 2 0 1 2 0 1 2 0 1 0 0 1
2 0 1 0 2 0 1 1 2 0 1 1 0 2 0 2 1 0 2 2 1 1 0 2 2 1 1 0 1 0
0 2 1 0 1 2 1 0 2 1 0 2 1 0 1 1 0 2 1 0 2 2 1 0 1 2 1 0 2 1
1 2 2 1 0 2 0 1 2 1 0 1 2 1 0 1 2 1 0 1 2 2 2 1 0 1 1 0 1 0
0 1 2 1 0 2 0 1 1 2 1 1 2 2 1 1 2 2 2 1 2 2 1 1 2 1 2 1 2 1
0 2 2 1 2 0 1 0 2 0 2 1 0 1 2 1 2 1 1 2 0 2 1 0 1 2 1 1 0 1
1 1 2 0 1 2 2 1 2 0 1 2 1 2 1 2 0 0 2 1 1 1 0 0 2 1 1 2 0 2
2 1 1 0 2 1 1 2 2 1 0 2 0 1 2 0 1 2 1 0 2 1 0 1 1 2 0 2 1 1
0 2 1 1 0 2 0 1 0 2 1 0 1 0 2 2 1 2 0 1 0 1 2 1 2 2 1 2 1 1
2 0 1 2 0 2 1 1 0 1 1 2 1 2 2 0 1 2 2 0 2 2 1 0 1 1 0 2 2 1
1 1 0 1 2 0 2 0 1 1 1 0 2 1 2 1 0 1 2 1 1 0 1 2 0 2 1 0 1 2
1 2 0 2 0 1 2 0 2 2 1 0 2 0 1 1 2 0 2 0 2 1 2 2 0 1 0 2 1 1
0 2 2 1 1 0 1 1 2 1 0 1 0 2 2 0 1 2 2 1 2 0 2 1 2 0 2 2 1 2
0 1 2 2 0 1 1 1 2 2 0 1 2 0 1 1 0 1 0 2 1 2 1 0 1 2 1 1 2 0
2 1 1 0 1 2 1 0 2 1 2 2 1 0 2 0 2 1 0 2 2 0 1 2 1 2 1 0 2 1
0 1 2 1 0 1 2 2 0 2 2 1 1 2 2 1 0 1 1 2 1 0 1 2 1 2 2 0 1 2
1 2 0 1 0 2 0 1 1 1 2 2 0 1 2 0 1 2 0 2 1 0 2 2 0 1 1 2 2 1
2 1 2 0 2 1 1 0 2 0 1 2 1 0 1 1 0 1 0 1 0 2 0 2 1 1 1 0 2 2
1 0 1 1 1 0 2 0 1 2 0 2 1 2 0 2 1 2 0 1 0 1 1 1 0 2 0 2 2 0
0 2 1 2 0 1 2 1 0 1 0 1 0 1 0 2 2 2 1 0 1 2 1 1 0 1 0 2 2 1
2 0 1 2 1 2 2 1 2 1 2 0 2 0 1 2 1 2 1 0 1 2 0 2 1 2 0 1 2 1
1 1 0 2 1 0 1 1 0 1 2 0 1 1 2 1 0 1 0 2 2 1 0 2 1 1 0 2 1 1
1 0 2 1 2 0 2 0 1 1 2 1 1 0 1 0 1 2 1 1 0 1 2 0 1 2 0 2 2 1
2 2 1 1 0 2 0 1 1 1 2 0 1 0 1 1 2 0 1 0 1 1 2 1 2 1 2 0 2 1
1 0 2 1 1 2 0 1 1 2 1 0 1 2 1 1 0 1 0 2 1 1 2 1 0 2 0 1 0 1
1 0 1 2 2 1 1 0 2 1 2 1 2 1 1 2 1 2 0 1 1 0 2 1 0 1 1 0 2 2
2 0 2 2 2 0 2 1 2 0 1 0 2 0 1 2 2 1 0 1 2 1 0 1 1 1 0 1 2 1
0 1 1 0 1 1 2 1 2 0 1 2 1 0 2 0 1 2 1 0 1 2 0 1 2 0 2 2 2 1