#this is a testing map
width: 70
height: 70
#start position in format x y
start: 10 10

16 16 16 16 17 17 17 17 17 16 16 16 16 16 16 16 16 16 16 16 16 16 16 16 16 16 16 16 16 16 16 17 17 17 17 17 17 17 17 17 17 17 16 16 16 16 16 16 16 16 16 16 16 16 16 16 16 16 16 16 16 16 16 16 16 16 16 16 16 16
16 16 16 21 25 25 25 25 25 20 16 16 16 16 16 16 16 17 17 17 16 16 16 16 16 16 16 16 16 16 21 25 25 25 25 25 25 25 25 25 25 25 20 16 16 16 16 16 16 16 16 16 16 16 16 16 16 17 17 17 17 17 17 17 17 16 16 16 16 16
16 16 16 21 25 25 25 25 25 20 16 16 16 16 16 16 19 25 25 25 20 16 16 16 16 16 16 16 16 16 21 25 25 25 25 25 25 25 25 25 25 25 18 16 16 16 16 16 16 16 16 16 16 16 16 16 21 25 25 25 25 25 25 25 25 20 16 16 16 16
16 16 16 21 25 25 25 25 25 18 17 17 17 17 17 19 25 25 25 25 20 16 16 16 16 16 17 17 17 17 19 25 25 25 25 25 25 25 25 25 25 25 25 18 16 16 16 16 16 16 16 16 16 16 16 16 21 25 25 25 25 25 25 25 25 20 16 16 16 16
16 16 16 21 25 25 25 25 25 25 25 25 25 25 25 25 25 25 25 25 18 17 17 17 17 19 25 25 25 25 25 25 25 25 25 25 25 25 25 25 25 25 25 25 18 17 17 17 17 16 16 16 16 16 16 16 21 25 25 25 25 25 25 25 25 20 16 16 16 16
16 16 16 21 25 25 25 25 25 25 25 25 25 25 25 25 25 25 25 25 25 25 25 25 25 25 25 25 25 25 25 25 25 25 25 25 25 25 25 25 25 25 25 25 25 25 25 25 25 18 17 17 17 17 17 17 19 25 25 25 25 25 25 25 25 20 16 16 16 16
16 16 16 21 25 25 25 25 25 25 25 25 25 25 25 25 25 25 25 25 25 25 25 25 25 25 25 25 25 25 25 25 25 25 25 25 25 25 25 25 25 25 25 25 25 25 25 25 25 25 25 25 25 25 25 25 25 25 25 25 25 25 25 25 25 20 16 16 16 16
16 16 16 16 24 25 25 25 25 25 25 25 25 25 25 25 25 25 25 25 25 25 25 25 25 25 25 25 25 25 25 25 25 25 25 25 25 25 25 25 25 25 25 25 25 25 25 25 25 25 25 25 25 25 25 25 25 25 25 25 25 25 25 25 25 20 16 16 16 16
16 16 16 16 21 25 25 25 25 25 25 25 25 25 25 25 25 25 25 25 25 25 25 25 25 25 25 25 25 25 25 25 25 25 25 25 25 25 25 25 25 25 25 25 25 25 25 25 25 25 25 25 25 25 25 25 25 25 25 25 25 25 25 25 25 20 16 16 16 16
16 16 16 16 21 25 25 25 25 25 25 25 25 25 25 25 25 25 25 25 25 25 25 25 25 25 25 25 25 25 25 25 25 25 25 25 25 25 25 25 25 25 25 25 25 25 14 25 25 25 25 25 25 25 25 25 25 25 25 25 25 23 22 22 22 16 16 16 16 16
16 16 16 16 16 24 25 25 25 25 25 25 25 25 25 25 25 25 25 25 25 25 25 25 25 25 25 25 25 25 25 25 25 25 25 25 25 25 25 25 25 25 14 25 25 25 14 25 25 25 25 25 25 25 25 25 25 25 25 25 25 20 16 16 16 16 16 16 16 16
16 16 16 16 16 21 25 25 25 25 25 25 25 25 25 3 25 25 25 25 25 25 25 25 25 25 25 25 25 25 25 25 25 25 25 25 25 25 25 25 25 25 14 25 25 25 14 25 25 25 25 25 25 25 25 25 25 25 25 25 25 20 16 16 16 16 16 16 16 16
16 16 16 16 16 19 25 25 25 25 25 25 25 25 25 3 25 25 25 25 25 25 25 25 25 25 25 25 25 25 25 25 25 25 25 25 25 14 14 25 25 25 14 25 25 25 14 25 25 25 25 25 25 25 25 25 25 25 25 25 25 20 16 16 16 16 16 16 16 16
16 16 16 16 19 25 25 25 25 25 25 25 25 25 25 3 25 25 25 25 25 9 8 8 8 8 10 25 25 25 25 25 25 3 25 25 25 25 14 25 25 14 25 25 25 25 14 25 25 25 25 25 25 25 25 25 25 25 25 25 25 18 17 17 16 16 16 16 16 16
16 16 16 21 25 25 25 25 25 25 25 25 25 25 25 3 25 25 25 25 9 0 0 0 0 0 7 25 25 25 25 25 25 3 25 25 25 25 14 25 14 25 25 25 25 14 14 14 25 25 25 25 25 25 25 25 25 25 25 25 25 25 25 25 20 16 16 16 16 16
16 16 16 21 25 25 25 25 25 25 25 25 25 25 25 3 25 25 25 25 11 0 0 0 0 0 7 25 25 25 25 25 25 3 25 25 25 25 14 25 14 25 25 14 14 25 14 25 14 25 25 15 2 2 2 2 2 2 2 2 2 25 25 25 20 16 16 16 16 16
16 16 16 21 25 25 25 25 25 25 25 25 25 25 25 3 25 25 25 25 11 0 0 0 0 0 7 25 25 25 25 25 25 3 25 25 25 25 25 25 14 14 14 25 25 14 25 25 14 25 25 3 25 25 25 25 25 25 25 25 25 25 23 22 16 16 16 16 16 16
16 16 16 21 25 25 25 25 25 25 25 25 25 25 25 3 25 25 25 25 11 0 4 4 4 4 6 25 25 25 25 25 25 3 25 25 25 25 14 14 14 14 14 14 14 25 25 25 14 25 25 3 25 25 25 25 25 25 25 25 25 25 20 16 16 16 16 16 16 16
16 16 16 21 25 25 25 25 25 25 25 25 25 25 25 3 25 25 25 25 5 6 25 25 25 25 25 25 25 25 25 25 25 3 25 25 25 25 14 25 25 25 25 25 25 25 25 25 14 25 25 3 25 25 25 25 25 25 25 25 25 25 18 16 16 16 16 16 16 16
16 16 16 21 25 25 25 25 25 25 25 25 25 25 25 3 25 25 25 25 25 25 25 25 25 25 25 25 25 25 25 25 25 3 25 25 25 25 14 25 25 25 25 25 25 25 25 25 14 25 25 3 25 25 25 25 25 25 25 25 25 25 25 20 16 16 16 16 16 16
16 16 16 21 25 25 25 25 25 25 25 25 25 25 25 3 25 25 25 25 25 25 25 25 25 25 25 25 25 25 25 25 25 3 25 25 25 25 14 25 25 14 25 25 25 25 25 14 25 25 25 3 25 25 25 25 25 25 25 25 25 25 25 20 16 16 16 16 16 16
16 16 16 21 25 25 25 25 25 25 25 25 25 25 25 3 25 25 25 25 25 25 25 25 25 25 25 25 25 25 25 25 25 3 25 25 25 25 14 25 14 25 14 25 25 25 25 14 25 25 25 3 25 25 25 25 25 25 25 25 25 25 25 20 16 16 16 16 16 16
16 16 16 21 25 25 25 25 25 25 25 25 25 25 25 3 25 25 25 25 25 25 25 25 25 25 25 25 25 25 25 25 25 3 25 25 25 25 14 25 25 25 14 25 25 25 25 25 25 25 25 3 25 25 25 25 25 25 25 25 25 25 25 18 16 16 16 16 16 16
16 16 16 21 25 25 25 25 25 25 25 25 25 25 25 3 25 25 25 25 25 25 25 25 25 25 25 25 25 25 25 25 25 3 25 25 25 25 25 25 25 25 14 14 25 25 25 25 25 25 25 3 25 25 25 25 25 25 25 25 25 25 25 25 18 16 16 16 16 16
16 16 16 21 25 25 25 25 25 25 25 25 25 25 25 3 25 25 25 25 25 25 25 25 25 25 25 25 25 25 25 25 25 3 25 25 25 25 25 25 25 25 25 25 25 25 25 25 25 25 25 3 25 25 25 25 25 25 25 25 25 25 25 25 25 20 16 16 16 16
16 16 16 21 25 25 25 25 25 25 25 25 25 25 25 3 25 25 25 25 25 25 25 25 25 25 25 25 25 25 25 25 25 3 25 25 25 25 25 25 25 25 25 25 25 25 25 25 25 25 25 3 25 25 25 25 25 25 25 25 25 25 25 25 25 18 16 16 16 16
16 16 16 16 22 22 24 25 25 25 25 25 25 25 25 15 2 2 2 2 2 2 2 2 2 2 2 2 2 2 2 2 2 15 2 2 2 2 2 2 2 2 2 2 2 2 2 2 2 2 2 15 2 2 2 2 2 2 15 25 25 25 25 25 25 25 18 16 16 16
16 16 16 16 16 16 16 24 25 25 25 25 25 25 25 25 25 25 25 14 14 25 25 25 25 25 25 25 25 25 25 25 25 3 14 14 25 25 25 25 14 14 25 25 25 25 25 25 25 25 25 25 25 25 25 25 25 25 3 25 25 25 25 25 25 25 25 20 16 16
16 16 16 16 16 16 16 21 25 25 25 25 25 25 25 25 25 25 14 25 25 25 25 25 25 25 25 25 25 25 25 25 25 3 14 14 14 14 14 14 14 14 14 14 25 25 25 25 13 25 25 25 25 25 25 25 25 25 3 25 25 25 25 25 25 25 25 20 16 16
16 17 17 17 17 17 17 19 25 25 25 25 25 25 25 25 25 14 25 25 25 25 25 25 25 25 25 25 25 25 25 25 25 3 25 14 14 14 14 14 14 14 14 14 25 25 13 13 13 25 13 25 25 25 25 25 25 25 3 25 25 25 25 25 25 23 22 16 16 16
21 1 1 1 1 1 1 1 1 25 25 25 25 25 25 25 14 25 25 25 25 25 25 25 25 25 25 25 25 25 25 25 25 3 14 14 14 14 14 14 14 14 14 14 25 25 13 13 13 13 13 13 13 13 25 25 25 25 3 25 25 25 25 25 25 20 16 16 16 16
21 1 1 1 1 1 1 1 1 25 25 1 1 1 25 14 25 25 25 25 25 25 25 25 25 25 25 25 25 25 25 25 25 3 14 14 14 14 14 14 14 14 14 14 25 25 13 13 13 13 13 13 13 13 25 25 25 25 3 25 25 25 25 25 23 16 16 16 16 16
21 1 1 1 1 1 1 1 1 1 1 1 1 1 25 14 25 25 25 25 25 25 25 25 25 25 25 25 25 25 25 25 25 3 25 14 14 14 14 14 14 14 14 14 25 25 13 13 13 13 13 13 13 25 13 25 25 25 3 25 25 25 25 25 20 16 16 16 16 16
21 1 1 1 1 1 1 1 1 1 1 1 1 25 25 14 25 25 25 25 25 25 25 25 25 25 25 25 25 25 25 25 25 3 25 25 25 25 25 25 25 25 14 25 25 25 13 13 13 13 13 13 13 13 13 13 25 25 3 25 25 25 25 25 20 16 16 16 16 16
21 1 1 1 1 1 1 1 1 1 1 1 1 1 1 1 25 14 14 14 14 14 25 25 25 25 25 25 25 25 25 25 25 3 25 25 25 25 25 25 25 25 25 25 25 25 25 13 13 13 13 13 13 13 13 13 25 25 3 25 25 25 25 25 20 16 16 16 16 16
21 1 1 1 1 1 1 1 1 1 1 1 1 1 1 1 1 25 25 25 25 14 25 25 25 25 14 25 25 25 25 25 25 3 25 25 25 25 25 25 25 25 25 25 25 25 25 13 13 13 13 13 13 13 13 13 25 25 25 25 25 25 25 25 20 16 16 16 16 16
16 22 22 22 24 25 25 1 1 1 1 1 1 1 1 1 1 1 25 25 25 25 14 25 25 25 14 25 25 25 25 25 25 3 25 25 25 25 25 25 25 25 25 25 25 25 25 13 13 13 13 13 13 13 13 13 25 25 25 25 25 25 25 25 20 16 16 16 16 16
16 16 16 16 21 25 25 1 1 1 14 1 1 1 1 1 1 1 1 25 25 25 14 25 25 25 14 25 25 25 25 25 25 3 25 25 25 25 25 25 25 25 25 25 25 25 25 13 13 13 13 13 13 13 13 13 13 13 25 25 25 25 25 25 20 16 16 16 16 16
16 16 16 16 21 25 25 25 25 1 14 1 1 1 1 1 1 1 1 1 25 25 14 25 25 25 14 25 25 25 25 25 25 3 25 25 25 25 25 25 25 25 25 25 25 25 25 13 13 13 13 13 13 13 13 13 13 13 25 25 25 25 25 25 20 16 16 16 16 16
16 16 16 16 16 22 24 25 25 25 25 25 25 1 1 1 1 1 1 1 1 1 14 25 25 25 14 25 25 25 25 25 25 3 25 25 25 25 25 25 25 25 25 25 25 25 25 25 25 13 13 13 13 13 13 13 13 13 25 25 25 25 25 25 18 16 16 16 16 16
16 16 16 16 16 16 21 25 25 25 25 25 25 25 1 1 1 1 1 1 1 1 1 25 25 25 14 25 25 25 25 25 25 3 25 25 25 25 25 25 25 25 25 25 25 25 25 25 25 25 25 13 13 13 13 13 13 13 13 25 25 25 25 25 25 18 16 16 16 16
16 16 16 16 16 16 21 25 25 25 25 25 25 25 25 14 25 1 1 1 1 1 1 25 25 25 14 25 25 25 25 25 25 15 2 2 2 2 2 2 2 2 2 2 2 2 15 25 25 25 13 13 13 13 13 13 13 13 13 13 25 25 25 25 25 25 20 16 16 16
16 16 16 16 16 16 21 25 25 25 25 25 25 25 25 25 14 25 1 1 1 1 1 1 1 25 14 25 25 25 25 25 25 25 25 25 25 25 25 25 25 25 25 25 25 25 3 25 25 25 13 13 13 13 13 13 13 13 13 13 13 25 25 25 25 25 20 16 16 16
16 16 16 16 16 16 21 25 25 25 25 25 25 25 25 25 14 25 25 25 1 1 1 1 1 1 14 25 25 25 25 25 25 25 25 25 25 25 25 25 25 25 25 25 25 25 3 25 25 25 13 13 13 13 13 13 13 13 13 13 13 25 25 25 25 25 20 16 16 16
16 16 16 16 16 16 21 25 25 25 25 25 25 25 25 25 25 14 25 25 25 25 1 1 1 1 1 14 14 14 25 25 25 25 25 25 25 25 25 25 25 25 25 25 25 25 3 25 25 25 13 13 13 13 13 13 13 13 13 13 13 25 25 25 25 25 20 16 16 16
16 16 16 17 17 17 19 25 25 25 25 25 25 25 25 25 25 25 14 25 25 14 25 25 25 1 1 1 14 14 25 25 25 25 25 25 25 25 25 25 25 25 25 25 25 25 3 25 25 25 25 13 13 13 13 13 13 13 13 13 13 13 25 25 25 25 20 16 16 16
16 16 21 25 25 25 25 25 25 25 25 25 25 25 25 25 25 25 25 14 14 25 14 14 14 25 25 25 25 14 25 25 25 25 25 25 25 25 25 25 25 25 25 25 25 25 3 25 25 25 25 13 13 13 13 13 13 13 13 13 13 13 25 25 25 25 20 16 16 16
16 16 21 25 25 25 25 25 25 25 25 14 25 25 25 25 25 25 25 25 25 25 25 25 25 25 25 25 25 14 25 25 25 25 25 25 25 25 25 25 25 25 25 25 25 25 3 25 25 25 25 13 13 13 13 13 13 13 13 13 13 25 13 25 25 25 20 16 16 16
16 17 19 25 25 25 25 25 25 25 14 14 25 25 25 25 25 25 25 25 25 25 25 25 25 25 25 25 25 25 25 25 25 25 25 25 25 25 25 25 25 25 25 25 25 25 3 25 25 25 25 25 13 13 13 13 13 13 13 13 13 13 13 25 25 25 18 16 16 16
21 25 25 25 25 25 25 25 25 25 14 25 25 25 25 25 25 25 25 25 25 25 25 25 25 25 25 25 25 25 25 25 25 25 25 25 25 25 25 25 25 25 25 25 25 25 3 25 25 25 25 13 13 13 13 13 13 13 13 13 13 13 13 25 25 25 25 18 16 16
21 25 25 25 25 25 25 25 25 14 25 25 25 25 25 25 25 2 2 2 2 2 2 2 15 2 2 2 2 2 2 2 2 2 2 2 2 2 2 2 2 2 2 2 2 2 15 25 25 25 25 13 13 13 13 13 13 13 13 13 13 13 13 25 25 25 25 25 20 16
21 25 25 25 25 25 25 25 14 25 25 25 25 25 25 25 25 25 25 25 25 25 25 25 3 25 25 25 25 25 25 25 25 25 25 25 25 25 25 25 25 25 25 25 25 25 3 25 25 25 25 13 13 13 13 13 13 13 13 13 13 13 13 25 25 25 25 25 20 16
21 25 25 25 25 25 25 25 14 25 25 25 25 25 25 25 25 25 25 25 25 25 25 25 3 25 25 25 25 25 25 25 25 25 25 25 25 25 25 25 25 25 25 25 25 25 3 25 25 25 25 13 13 13 13 13 13 13 13 13 13 13 13 25 25 25 25 25 20 16
21 25 25 25 25 25 25 25 14 25 25 25 25 25 25 14 14 25 25 25 25 25 25 25 3 25 25 25 25 25 25 25 25 25 25 25 25 25 25 25 25 25 25 25 25 25 3 25 25 25 25 25 25 13 13 13 13 13 13 13 13 13 13 25 13 25 25 25 20 16
21 25 25 25 25 25 25 25 14 25 25 25 25 14 14 25 25 14 25 25 25 25 25 25 3 25 25 25 25 25 25 25 25 25 25 25 25 25 14 25 25 25 25 25 25 25 3 25 25 25 25 25 25 13 13 13 13 13 13 13 13 13 13 13 25 25 25 25 20 16
21 25 25 25 25 25 25 14 25 25 25 25 14 25 25 25 25 14 25 25 25 25 25 25 3 25 25 25 25 25 25 25 25 25 25 25 25 14 14 14 25 25 25 25 25 25 3 25 25 25 25 25 25 13 13 13 13 13 13 13 13 13 13 13 25 25 25 25 20 16
21 25 25 25 25 25 25 14 25 25 25 14 25 25 25 25 25 14 25 25 25 25 25 25 3 25 25 25 25 25 25 25 25 25 25 25 14 14 14 14 25 25 25 25 25 25 3 25 25 25 25 25 25 13 13 13 13 13 13 13 13 13 25 13 25 25 25 25 20 16
21 25 25 25 25 25 25 14 25 14 14 25 25 25 25 25 25 14 25 25 25 25 25 14 3 25 25 25 25 25 25 25 25 25 25 14 14 25 25 14 14 25 25 25 25 25 3 25 25 25 25 25 25 13 13 13 13 13 25 13 13 13 13 25 25 25 25 25 20 16
21 25 25 25 25 25 25 25 14 25 25 25 25 25 25 25 25 14 25 25 14 14 14 25 3 25 25 25 25 14 14 25 25 25 14 25 14 25 25 25 25 14 25 25 25 25 3 25 25 25 25 25 14 25 25 13 13 13 13 13 13 13 25 25 25 25 25 25 20 16
21 25 25 25 25 25 25 25 25 25 25 25 25 25 25 25 25 14 25 14 25 25 25 25 3 25 25 25 25 14 14 25 25 14 25 25 25 25 25 25 25 14 25 25 25 25 3 25 25 14 14 14 14 25 25 25 13 13 13 13 25 25 25 25 25 25 25 25 20 16
21 25 25 25 25 25 25 25 25 25 25 25 25 25 25 25 25 14 14 25 25 25 25 25 3 25 25 25 14 25 14 14 14 25 25 25 25 25 25 25 25 25 14 14 14 14 3 25 25 14 25 25 23 22 22 24 25 13 25 25 25 25 25 25 25 25 25 25 20 16
16 22 22 24 25 25 25 25 25 25 25 25 25 25 25 25 25 25 25 25 25 25 25 25 14 25 25 14 25 25 25 25 25 25 25 25 25 25 25 25 25 25 25 25 25 14 3 25 14 25 25 25 20 16 16 21 25 25 25 25 25 25 25 25 25 25 25 25 20 16
16 16 16 21 25 25 25 25 25 25 25 25 25 25 25 25 25 25 25 25 25 25 25 25 14 25 14 25 25 25 25 25 25 25 25 25 25 25 25 25 25 25 25 25 25 14 14 14 25 25 25 25 20 16 16 21 25 25 25 25 25 25 25 25 25 23 22 22 16 16
16 16 16 19 25 25 25 25 25 25 25 25 25 25 25 25 25 25 25 25 25 25 25 25 14 14 25 25 25 25 25 25 25 25 25 25 25 25 25 25 25 25 25 25 25 14 14 25 25 25 25 25 20 16 16 21 25 25 25 25 25 25 25 25 23 16 16 16 16 16
16 16 21 25 25 25 25 25 25 25 25 25 25 25 25 25 25 25 25 25 25 25 25 25 14 25 25 25 25 25 25 25 25 25 25 25 25 25 25 25 25 25 25 25 25 25 25 25 25 25 25 25 20 16 16 21 25 25 25 23 22 22 22 22 16 16 16 16 16 16
16 16 21 25 25 25 25 25 25 25 25 25 25 25 25 25 25 25 25 25 25 25 25 25 25 23 22 22 22 22 22 22 22 22 22 22 24 25 25 25 25 25 25 25 25 25 25 25 25 25 25 25 20 16 16 21 25 25 25 20 16 16 16 16 16 16 16 16 16 16
16 16 21 25 25 25 25 25 25 25 25 25 25 25 25 25 25 25 25 25 25 25 25 25 25 20 16 16 16 16 16 16 16 16 16 16 21 25 25 25 25 25 25 25 25 25 25 25 25 25 25 25 20 16 16 21 25 25 25 20 16 16 16 16 16 16 16 16 16 16
16 16 16 22 22 22 22 22 22 24 25 25 25 25 25 25 25 25 25 23 22 22 22 22 22 16 16 16 16 16 16 16 16 16 16 16 16 22 22 22 22 22 22 22 22 22 22 22 22 22 22 22 16 16 16 16 22 22 22 16 16 16 16 16 16 16 16 16 16 16
16 16 16 16 16 16 16 16 16 16 22 22 22 22 22 22 22 22 22 16 16 16 16 16 16 16 16 16 16 16 16 16 16 16 16 16 16 16 16 16 16 16 16 16 16 16 16 16 16 16 16 16 16 16 16 16 16 16 16 16 16 16 16 16 16 16 16 16 16 16
16 16 16 16 16 16 16 16 16 16 16 16 16 16 16 16 16 16 16 16 16 16 16 16 16 16 16 16 16 16 16 16 16 16 16 16 16 16 16 16 16 16 16 16 16 16 16 16 16 16 16 16 16 16 16 16 16 16 16 16 16 16 16 16 16 16 16 16 16 16